1111111111111
1C0P00C000CC1
1111110XX1C11
1111110XX1C11
1E00000000CC1
1111111111111