1111111111111
1C0P00C0000C1
1111111111011
1111111111011
1E000000000C1
1111111111111