1111111111111
100P00C000CC1
1111110XX1111
111111CXX1111
1E00000000CC1
1111111111111