111111111111111111111111
10C0100C0000000110000001
100100000000000011100C01
100100C00000000C00001001
1010010010111000100000C1
100001000000000100C11011
1110100000110001000C1001
10101110001101010C00C101
11C0000C0001001100110011
100000000010111001000101
100011100000110000C10001
100100111111000000000001
100C11100C00000000000011
100000C0C100010000001001
110001010000000001000001
10011C010010C00000000001
101000000C100C0010000001
101000001000010101000001
110010011000111011001001
10C100100001001000000001
1001100000100000C0100101
100000100000000001001011
100110000000010100001001
1010C0000010000000C01001
10011100000010110000C001
101000001000110000C01001
111C00000000000001001101
100100000E01000011100001
10000100001000C100000011
1001010010C00110000100C1
100010110C10000100000101
1000C0010010100000000001
10101P00001111000C100111
111000000000011011110101
111111111111111111111111