11111111
10000111
1C0000C1
10010001
11001001
10001001
10000011
10101C01
10100001
1001P001
10010101
1C0000C1
10110001
11101101
11000101
10000C01
10001101
10010001
11001001
11001001
1001C001
11100001
11000011
10000101
1010C001
11100001
100000E1
10000011
10000001
10000001
11001001
10110001
11010101
10000111
11111111