11111111111111111111111111111111111111111111111111
10000000000000000000000000000000000000000000000001
1100001001101000P11000000000C000C1000C001101010011
100100010000CC01000011C000000010000000001010100E11
110010000001010001000000100100000000100000C0000001
101011000C000000010000010110100010000010010C010101
11111111111111111111111111111111111111111111111111